NO ./minilibx-linux/test/open.xpm
SO ./minilibx-linux/test/open.xpm
WE ./minilibx-linux/test/open.xpm
EA ./minilibx-linux/test/open.xpm

F                           			 100,100,100
C 20,            20,50

1111111111111111111111111111111111111111
1000000000000000000000000000000000000001
1011111111111111111111111111111111111101
1010000000000000000000000000000000000101
1010111111111111111111111111111111110101
1010100000000000000000000000000000010101
1010101111111111111111111111111111010101
1010101000000000000000000000000001010101
1010101011111111111111111111111101010101
1010101010000000000000000000000101010101
1010101010111111111111111111110101010101
1010101010100000000000000000010101010101
1010101010111111111111111111110101010101
1010101010000000000000000000000101011111
1010101011111111111111111111111101011N11
1010101000000000000000000000000001011111
1010101111111111111111111111111111010101
1010100000000000000000000000000000010101
1010111111111111111111111111111111110101
1010000000000000000000000000000000000101
1011111111111111111111111111111111111101
1000000000000000000000000000000000000001
1111111111111111111111111111111111111111
