NO ./src/minilibx-linux/test/open.xpm
SO ./src/minilibx-linux/test/open.xpm
WE ./src/minilibx-linux/test/open.xpm
EA ./src/minilibx-linux/test/open.xpm

F 60,40,20
C 10,10,30

11111111111111111111111111111111111111
10000000000000100000000000100000000001
10011111011100101111111001011011110101
10010001010000101000001001001010000101
10010001010111101011101001101010000101
10010001010100000010100000000010000101
10011111011111111010001111111011110101
10000000000000000010000000000000000101
11111110111111101011111111101111111101
10000001010000000000000000101000000101
10011100101011111111111000101011100101
10010000101010000000001000001000100101
10010000101010011110001000001000100101
10010000101010010010001000001000100101
10011100101010011110001000101011100101
10000001010000000000001000101000000101
11111100101111111111110001101011111111
10000100100000000000000001101000000001
10000100101111111111111111101011111101
10000100001000000000000000001010000001
10000111101011111111111111111010000001
1000000000010100000N000000000000000001
10011111111010011111111111111111110101
10010000000010010000000000000000010101
10010011111110010011111111111111010101
10010010000000010010000000000001010101
10010010111111110010011111111001010101
10010010100000000010010000001001010101
10010010101111111110010111110101010101
10010010101000000000010100000101010101
10011110101011111111110101111110110101
10000000101010000000000101000000000101
11111111101010011111100101011111111101
10000000101010010000100101000000000001
10011100101010010110100101011111111001
10010000101010010010100001000000001001
10010000101010010010100001011111101001
10010000101010010010100001010000001001
10011100101011110010100001010111001001
10000000101000000010100001010001001001
11111111111111111111111111111111111111
