NO ./minilibx-linux/test/open.xpm
SO ./minilibx-linux/test/open.xpm
WE ./minilibx-linux/test/open.xpm
EA ./minilibx-linux/test/open.xpm

F 180,120,60
C 30,30,80

111111111111111111111111111111
100000000001000000000000000001
101111111001011111111111011101
101000001001010000000001010001
101011101001010111111001010001
101010001001010100001001010001
101010111001010101101001010001
101010100001010101001001010001
101010101111010101001111010001
101010100000010100000000010001
101011101111110111111110110001
100000000000000000000000000001
101111111111011111111111111101
100000000001000000000000000001
101111111001011111110111111101
101000001001010000010100000101
101011101001010111010100010101
101010001001010101010100010101
101010111001010101010111010101
101010100001010101000000010001
101010100001N10100000000010001
101011101111110111111110110001
100000000000000000000000000001
111111111111111111111111111111
