	NO  ./minilibx-linux/test/open.xpm	
 SO 	./minilibx-linux/test/open.xpm  	 
	 	WE   	./minilibx-linux/test/open.xpm 
EA ./minilibx-linux/test/open.xpm	

F 50 ,			99999999999999999999999999999	,   50 	
C 50 ,   50 	 		,  200 	
		 
111111111111
100000000001	
101000000001 
1010W0000001
101000000001                  			
100000000001
111111111111
